31
31
PPPPPPPPPPPPPPPPPPPPPPPPPPPPPPP
PPPPPPPPPPPPPPPPPPPPPPPPPPPPPPP
PPPPPPPPPPPPPPPPPPPPPPPPPPPPPPP
PPPAAAAAAAAAAAAAAAAAAAAAAAAAPPP
PPPAAAAAAAAAAAAAAAAAAAAAAAAAPPP
PPPASSSSSSSSSSSSSSSSSSSSSSSAPPP
PPPSSSSSSSSSSSSPPPPPPPPPPPXXPPP
PPPSSSSSSSSSSSSPXXXXXXXXXXXXPPP
PPPSSSSSSSSSSSSPXXXXXXXXXXXXPPP
PPPSSSSSSSSSSSSPXXPPPPPPPPPPPPP
PPPSSSSSSSSSSSSPXXXXXXXXXXXXPPP
PPPSSSSSSSSSSSSPXXXXXXXXXXXXPPP
PPPSSSSSSSSSSSSPPPPPPPPPPPXXPPP
PPPSSSSSSSSSSSSPXXXXXXXXXXXXPPP
PPPSSSSSSSSSSSSPXXXXXXXXXXXXPPP
PPPSSSSSSSSSSSSPXXPPPPPPPPPPPPP
PPPSSSSSSSSSSSSPXXXXXXXXXXXXPPP
PPPSSSSSSSSSSSSPXXXXXXXXXXXXPPP
PPPSSSSSSSSSSSSPPPPPPPPPPPXXPPP
PPPSSSSSSSSSSSSPXXXXXXXXXXXXPPP
PPPSSSSSSSSSSSSPXXXXXXXXXXXXPPP
PPPSSSSSSSSSSSSPXXPPPPPPPPPPPPP
PPPSSSSSSSSSSSSPXXXXXXXXXXXXPPP
PPPSSSSSSSSSSSSPXXXXXXXXXXXXPPP
PPPSSSSSSSSSSSSPPPPPPPPPPPXXPPP
PPPBSSSSSSSSSSSSSSSSSSSSSSSBPPP
PPPBBBBBBBBBBBBBBBBBBBBBBBBBPPP
PPPBBBBBBBBBBBBBBBBBBBBBBBBBPPP
PPPPPPPPPPPPPPPPPPPPPPPPPPPPPPP
PPPPPPPPPPPPPPPPPPPPPPPPPPPPPPP
PPPPPPPPPPPPPPPPPPPPPPPPPPPPPPP
