100
100
PPPPPPPPPPPPPPPPPPPPPPPPPPPPPPPPPPPPPPPPPPPPPPPPPPPPPPPPPPPPPPPPPPPPPPPPPPPPPPPPPPPPPPPPPPPPPPPPPPPP
PPPPPPPPPPPPPPPPPPPPPPPPPPPPPPPPPPPPPPPPPPPPPPPPPPPPPPPPPPPPPPPPPPPPPPPPPPPPPPPPPPPPPPPPPPPPPPPPPPPP
PPPPPPPPPPPPPPPPPPPPPPPPPPPPPPPPPPPPPPPPPPPPPPPPPPPPPPPPPPPPPPPPPPPPPPPPPPPPPPPPPPPPPPPPPPPPPPPPPPPP
PPPTTTTTTTTTTTAAATTTTTTTTTTTTTTTTTTTTTTTTTTMMMMMMSSMMMMMTTTTTTTTBBBBBBTTTTTTTTTTTTTTTTTTTAABBBBBBPPP
PPPTTTTTTTTTTTAATTTTTTTTTTTTTTTTTTTTTTTTTMMMMMMMMKDMMMMMMTTTTTBBBBBBBBTTTTTTTTTTTTTTTTTTAAABBBBBBPPP
PPPTTTTTTTTTTAAATTTTTTTTTTTTTTTTTTMMMMMMMMMMMMMMMDKMMMMMMMMMMMMMBBBBBBTTTTTTTTTTTTTTTTTTAABBBTBTTPPP
PPPTTTTTTTTTAAATTTTTTTTTTTTTTTTTTTMMMMMMMMMSSSSSSSSSSSSMMMMMMMMMMBBBBBBTTTTTTTTTTTTTTTTAABBBBTBTTPPP
PPPTTTTTTTTTAATTTTTTTTTTTTTTTTTTMMMMMMMMMMSSSSSSSSSSSSSSMMMMMMMMMMMBBBBBTTTTTTTTTTTTTTTAABBBBBBTTPPP
PPPTTTTTTTTAAATTTTTTTTTTTTTTTTMMMMSSSSSSSSSSSSSMMSSMSMSSSSSSSSSSMMMMMMMBBTTTTTTTTTTTTTAABBBBBBBTTPPP
PPPTTTTTTTTAATTTTTTTTTTTTTTTTMMMMMSSSSSMSMMMSMMMMSSMSMXXSSSSSSSSSMMMMMMMBTTTTTTTTTTTTTAABBBBBBTTTPPP
PPPTTTTTTTAATTTTTTTTTTTTTTTMMMMMSSSMSMSMSMSSSMSSMSSMSMXXSMSMSSSSSSSSSMMMMMBBTTTTTTTTTTAABBBBTTTTTPPP
PPPTTTTTTTAATTTTTTTTTTTTMMMMMMMSSMMMSMSMSMSMMMSSMSSMMMSMSMSMSMSMSSSSSSMMMMMBTTTTTTTTTTAABBBBBBTTTPPP
PPPTTTTTTTAATTTTTTTTTTTMMMMMMSSSSMSSSMSMSMSSSSSMMSSMSSSMSMSMSMSMSSSSSSSMMMMMTTTTTTTTTTAABBBBBBBTTPPP
PPPTTTTTTAAATTTTTTTTTTMMMMMSSSSMSMSMMMSMMMMMMMMMMSSMMMSMMMSMSMMMSMMMMSSSSMMMMTTTTTTTTTTABBBBBBBTTPPP
PPPTTTTTAATTTTTTTTTTMMMMMMSSSSSMSMSMSMSSSSSSSMSSMSSMSMSMSSSMBBBBBMSSSMSSSSMMMMMBBTTTTTTAABBBBBBTTPPP
PPPTTTTAAATTTTTTTTTMMMMMSSSMMMSMSMSMSMMMMMMMSMSSMSSMSMSMSMMMBBBBBMSMSMSSSSSMMMMMBBTTTTTAABBBBBBBTPPP
PPPTTTAAATTTTTTTTTMMMMMSSSSMSSSMSMSSSMSSSMSSSMSSMSSMSSSMSMSSBSSSBMSMSMSMSSSSMMMMMBBTTTTTAABBBBBBTPPP
PPPTTAAATTTTTTTTTMMMMMSSSSSMMMSMSMMMTTTTTMSMSMSMMSSMMMMMSMMMBSBSBMSMSMSMMSSSSMMMMMBBTTTTAAABBBBBTPPP
PPPTAAATTTTTTTTTMMMMSSSSSSSSSMSMSSSMTTTTTMSMSMSTTSSTTSSMSSSKBSSSBMSMSSSMSSSSSSSMMMMBTTTTTAAABBBTTPPP
PPPAAATTTTTTTTTTMMMMSSSMMSSSSMMMSMMMTSSSTMSMMMMTTSSTTMSMSMMMBBBBBMSMMSMMSSBBSSSSMMMMTTTTTTAABBBBTPPP
PPPAATTTTTTTTTTMMMMSSSSMMMSSSSMMSSSSSSTSSSSSSSSSMSSTTMSMSSSMBBBBBMSMSSMSSSBBBSSSSMMMMTTTTTTAAABBBPPP
PPPATTTTTTTTTTMMMMSSSMMMMMSSSSSMSMSMTSSSTMMMMMMMMSSTTMSMMMSMSMMMMMSMSMSSSMMBBBSSSSMMMMBBTTTBAABBBPPP
PPPTTTTTTTTTTMMMMSSSSMSSSMSSSSSMSMSSTTTTTSSMSSSSMSSTTMSSSMSMSSSSSMSMMMSSMMSMBBBSSSSMMMMBTTTBBAABBPPP
PPPTTTTTTTTTMMMMSSSBBMSMSMSSSSSSMMSMTTTTTMSMSMMMMSSMSMMMSMSMMMMMSMMMSSSMMMSMMBBMSSSSMMMBTTTTBBAABPPP
PPPTTTTTTTTMMMMSSSBBBMSMSMSSSSSSMMSSSSSSSMSMSMSSSSSMSMSMSMSSSSSMSSMMSSSMSMSSSSKMSSSSSMMMTTTTTBAABPPP
PPPTTTTTTTTMMMSSSBBBSMSMSMSSSSSSSMMMSMSMMMSMSMSBBSSBBSSMSMMMMMSMMMMSSSMMSMMMMMSMMMMSSSMMMTTTTBBAAPPP
PPPTTTTTTTTMMMSSSBBKSSSMSMMSSSSSSSMMSSSMSSSMSSBBBSSBBBSMSSSMSMSMSMSSSMSMSSSSSMSSSSSSSSSMMTTTTTBBBPPP
PPPTTTTTTMMMMSSSMMMMMMMMSMMMSSSSSSSMSMSMSMMMSBBBBSSBBBBSMMSMSMSMSSSSSMSMSMMMSMMMMMSMSSSMMMTTTTBBBPPP
PPPTTTTTTMMMSSSMSSSMSSSMSSSMMSSSSSSMMMSMSSSMSBBBSSSSBBBSSSSMSSSMMMSSMMSMSMSSSMSSSMSMSSSMMMMTTTTBBPPP
PPPTTTTTTMMMSSSMSMSMSMSMSMMMMTTSSSSSSMSMSMSMSBBBSBBSBBBSMMMMMMTTMSSMMMSMSMSMSMMMSMSMMSSMMMMMTTTBBPPP
PPPTTTTTMMMSSSSSSMSMSMSSSMSSSTTTSSSSSMSSSMSMSBBBSBBSBBBSSSSSSTTTSSSMSMSMSMSMSSSSSMSSSMSSSMMMTTTTBPPP
PPPTTTTTMMSSSMMMMMSMSMMMMMSMMTTTSSSSSMMMMMSSSBBBSSSSBBBSSMMMTTTSSSTTSMSMMMSMMMMMSMMMSMSSSSMMTTTTTPPP
PPPTTTTMMMSSSMSSSMSSSMSSSSSMSMSMSSSSSSMSSSSSSBBBBSSBBBBSSMSSTTTSSMTTSMSSSSSMSSSMSMSMSSSSSSMMMMTTTPPP
PPPTTTMMSSSSSMMMSMMMMMMMMMSMSMSMMSSSSSMMSMMMSSBBBSSBBBSDSSSMMTSSSMMMSMMMMMMMMMSMSMSMMMMMSSMMMMTTTPPP
PPPTTTMMSSSMSSSSSSSSSSSMSSSMSSSMTTSSSSSSSMMSSSSBBSSBBSSSSMSSSSSSMMSSSMSSSSSSSMSMSSSMSSMMSSSMDSTTTPPP
PPPTTTMMSSMMMMAAAAAMMMSMSMMMMMSMTTSSSSSSSSMMMMSSSSSSSSSMSMSMSSMMMMSMSMMMSMMMSMSMMMSMSMMMSSSDDKSTTPPP
PPPTTTSKSSMMMMAAAAASSSSMSSSSSMSSSSMSSSSSSSMMSSSMSSSSSSSSSMMSSSSSSSSMSSSSSMSMSSSDAAAASMSSSSSSSKSTTPPP
PPPTTTSKSSSSSMMMMMDMMMSMSMMMSMMMMMSSSSSSSSMMSMSMMSSMMMMMMMMSSMMMSSSMMMMMMMSMMMSMAAAAMMSSSSSSSMMMTPPP
PPPTTMDDSSSSSSSSMMSMSSSMSSSMSSSMSSSMMSSSSSSMMMSSMSSMSSSSSSSSSMSSSMSSSSSSSMSSSSSMSSSSSSSSSSSSSMMMTPPP
PPPTMMMSSSSSSSSSSMMMSMSMMMBBBBBBSMSSSMSSSSSSMMSMMSSMMMSMMSSMMMMMMMSMSBBBBBBMMMMMSSSSSSSMMMMSSMMMTPPP
PPPTMMSSSMMMMMSSSSSMMMMMSBBBBBBBBMSMSMSSSSSSSMSSMSSMSMSMMSSSSMSMSSSMBBBBBBBBSSSSSSSSSSSMSSSSSMMMTPPP
PPPTMMSSSMSMMMMMMMSSSSMMBBBBAABBBBSSMMMSSSSSSMMMMSSMSMSMSSMMMMSMSMSBBBBBBBBKSSSSSMMMMMMMSMMSSMMMTPPP
PPPTMMSSSSSMSSSMSMMSSSSSSSBSAASBBBMSSSMMSSSSSSMMMSSMSSSMSMSMSSSSMMSBBSSSSSSSSSSMMSSSSSSMSSSSSMMMTPPP
PPPTMMSSMMMMSMSMSMMMMMSSSSSSBBSSBBMMMSSMMSSSSSSSMSSMSSMSMMSMSMMSSSSSSSSBBSSSBMMMMMMSMMMMSMMSSMMMTPPP
PPPTMMSSSSSMSMSSSSSSSMSSBBSSBBSSSSSSMMSSSMSSSSSSSSSSSSSSSSSMSMSSSSSSSSSBBSBBBSSMSSSSSSSSSMSSSMMMTPPP
PPPTMMSSSMSMSMMMMMMMSMMSBBBSSSSBSSSSMMMMSSMSSSSSSSSSSSSSSMSMMSSMMMMBBBSSSSBBBMMMSMMMMMMMMMSSSMMMTPPP
PPPTMMSSSMSSSMSSSMSSSMSSBBBBBBBBBBSSSSSMMMMSSSSSSSSSSSSSSMMSSSMMMSSBBBBAABBBBSSMSSSMSSSMSSSSSMMMTPPP
PPPTMMSSMMMMMMMMSMSMMMMMSBBBBBBBBMXXSSSSSSSSSSDDSSSSKKSSSSSSMMMMMMSMBBBAABBBMMSMMMSMSMMMSMMSSMMMMPPP
PPPTMMSSSMSSSSSSSMSMSSSSSSBBBBBBSMXXMMMMSSSSSSDDSSSSKKSSSSMMSSSSSMSMSBBBBBBMSMSSSMSMSMSSBBSSSMMMMPPP
PPPMMMSSSMSMSMMMSMSMMMSMMMMMSSSMSMSMMMMMMSSSSSSSSSSSSSSSSSSMSMMMSMSMMMSMMMSMSMMMSMSMSMSMBBSSSMMMMPPP
PPPMMMSSSMSMSMSSSMSSSSSMSSSMSSSSSMSSSBBBMMSSSSSSSXXSSSSSSSSMSSSMSMSSSMSMSSSMSSSMSSSMSMSKBBSSSSMMMPPP
PPPMMMSSMMSMSMMMMMMMMMMMSMSMSMSMSMMSSBBBMMSSSSSSSXXSSSSSSSSMMMMMSMMMMSSMSMMMSMSMMMMMSMMMBBSSSMMMBPPP
PPPMMMSSSSSMSSSSSSSSSSSMSMSMSMSSSMSSMMMMSSSSSSSSSSSSSSSSSSSSSMMMSMSSSSSMSMSMSMSSSMSSSSSSBBSSSMMMBPPP
PPPMMMSSSMMMMMMMMMMAAAAMMMSMSMSSMMMMSSSSSSSSSSKKSSSSDDSSSSSSSSSMSMSMSMMMSMSMSMSMSMMMMMSMBBSSSMMMBPPP
PPPTMMSSSMSSSSSSSMSAAAADKSSMTTTSMSSSSSSSSSSSSSKKSSSSDDSSSSSSSSSSSMMMSMSSSMSSSMSMSSSSSMSSSSSSSMMMBPPP
PPPTMMSSMMSMMMSMMMSAAAABBMMMTTTSSSSSSSSSMMMSSSSSSSSSSSSSSSSSSSSSSSSSSMMMTTTTMMSMSMMMSMSMMMMSSMMMBPPP
PPPTMMSSSMSSSMSMSSSAAAABBMMMSSSSSSSSSTTMSSSMSSSSSSSSSSSSSSSSSMSSSSSSSSSSTTTTMSSMSMSSSMSSSMSSSMMMBPPP
PPPTMMSSSMSMMMSMSMMMMMMMMSSSSSSSSSTTTTTMSMMSSSSSSSSSSSSSSSSSSMMMMMSSSSSSSSSSMMSMSMSMMMSMMMSSSMMMBPPP
PPPTMMSSSSSMSSSMMMMMMSSSSSSSSSMMMSTTTMSSSMMSSSSSMSSMSSSSSSSMMMSSSMMSSSSSSSSSSSSSMMMMSSSMSSSSSMMBBPPP
PPPTTMSSSMMSSMMMMSSSSSSSSSSMMMSMMSSMMMSMSMSSSMSSMSSMMSSSSSSMSSSMSMSSMMMMSSSSSSSSSSMMMMMMSMSSSMMBBPPP
PPPTTMMSSMSSMMSSSSSSSSSSMMMSSSSMSMSMSSSMSMSSMMMSMSSMMMMMSSSMMMSMSSSSSSSMMMMMMSSSSSSSSMMMMMSSMMMBBPPP
PPPTTMMSSSMSMSSSSSSSSMMMSMSMSMMMSMSMSMSMSSSMMMMMMSSMSSSSMSSSMMMMMSSMSSSMSSMSMMMMSSSSSSSSSSSSMMMBBPPP
PPPTTMMSSSSSSSSSSMMSMMSSSMSMSSSMSSSSMMMSSSSMSSSSMSSMSSSSMSSSSSSSMSMMMMSSSSSSSSSMMMMSSSSSSSSSMMMBBPPP
PPPTTMMMSSSSSSMMMMMSSSMMSMSMMMSMSMBBBBBBSSMMSMSMMSSMMSMMSMSSBBBBBBSSMMMMSMMMSMMMMMMMMMSSSSSMMMBBBPPP
PPPTTMMMSSSMMMMMSSSSSSSSSMSSSMSSSBBBBBBSSSMMSMSMMSSMSSSMSSSSSBBBBBBSMSSTSSSMSBBBBBBMSMMMMSSMMMBBBPPP
PPPTTTMMSSMMMMSMSMSMMMMMMMMMSMSMBBBBBBSSBBMMMMSMMSSMSMMMMMBSSSBBBBBBMMSMMMSMMBBBBBBMSMSMSSSMMBBBBPPP
PPPTTTMMSSSMSMSMSMSSSMSSSSSSSMSSBBBSSSSBBBSMSSSMMSSMSSSSSMBBSSSSSBBBSMSSSMSMKBBBBBBMSMSMSSSMMBBBBPPP
PPPTTMMMSSSMSMSMMMMMSMSMMMMMMMSMBBBSBBSBBBSSSSSSSSSSSSSSSSBBBSBBSBBBSMMMMMSMMBBBBBBMSMSSSSMMMBBBBPPP
PPPTTMMMSSSMSSSMSSSSSMSSSSSMSSSMBBBSBBSBBBSMSSSTTSSMSMSSSMBBBSBBSBBBSMSSSMSSSBBBBBBSSMSSSSMMMBBBBPPP
PPPTTTMMMSSSSMMMSMMMMMSAAADMMMSMBBBSSSSBBBSMSMSTTSSMSMSMMMBBBSSSSSBBMMMMSMSMSMMMSMMMMMSSSMMMBBBBBPPP
PPPTTTMMMMSSSMSMSSSSSSSAAASSSMSMBBSSBBBBBBSMSMSTTSSMSMSSSMBBBBBBSSBBSSSSSMSMSSSMSMSSSSSSSMMMBBBBBPPP
PPPTTTTMMMSSSMSMSMMMMMMAAAMMSMSMKSSBBBBBBSSMMMSTTSSMMMMMMMMBBBBBBSDMSMMMMMMMSMSMSMMMSSSSMMMBBBBBBPPP
PPPTTTTTMMMSSSSSSMSSSSSAAASSSMSSSSSBBBBBSSSSSSSTTSSMSMSSSSSMBBBBBSSMSSSSSSSMSMSMSSSSSSSSMMBBBBBBAPPP
PPPTTTTTTMMMSSMMMMSMMMSAAASMMMMMSSMMSSSMMMMMMMMTTSSMSMSMSMMMMMMMMSSSMMMMMMSMMMSMMMMSSSSMMMBBBBBAAPPP
PPPTTTTTTTMMSSSSSSSMSSSMSMSSSSSMSSMSSMSSSSSSSSSSMSSMSMSMSMSSSSSSMMSSSMAAAAASSSSMSSSSSSSMMBBBBBAAAPPP
PPPTTTTTTTMMMSSSMMMMSMMMSMMSSMMSSMSMMMMMMMMMMMMMMSSMSMSMSMSMMMMMMMSSSSAAAAAMMMSMSSSSSMMMMBBBBAAABPPP
PPPTTTTTTTMMMMSSSSSSSMSSSMSSMMSSMMSSSSSMSSSSSMSSMSSMSMSMAAAASSSSSMMSSSMMDAAMSSSMSSSSSMMMBBBBAAAABPPP
PPPTTTTTTTTMMMMSSSMMMMSMSMSMMSSSMMMSMMSMMMMMSMSMMSSTTMMMAAAADMMMMMMMSSSMMAAMSMMMSSSSMMMABBBBAABBBPPP
PPPTTTTTTTTTMMMSSSSMSSSMSMSMMSSMMSSSSMSSSSSSSMSSMSSTTMSSSSSMSMSSSSSMSSSSMAAMSMSSSSSSMMAAABBBAABBBPPP
PPPTTTTTTTTTTMMMSSSSMMSMSMMMSSMMSMSMMMMMMMMMSAAMMSSTTMSMMMSMMMSMMMMMMSSSMAAMSMSSSSMMMMBAAABAABBBBPPP
PPPTTTTTTTTTTMMMMMSSSSSMSMMSSSMSSMSMSSSSSSSMSAAMMSSTTMSMSMSSSSSMSSSMMSSSSMMMSSSSSMMMMBBAAAAAABBBBPPP
PPPTTTTTTTTTTTMMMMMSSSSMSMSSSMMMSMMMSMMMMMSMSAAMMSSMSMSMSMMMMMMMSMSMMMSSSSMMSSSMMMMMBBBBAAAABBBBBPPP
PPPTTTTTTTTTTTTTMMMSSSSSMMSSMMSMSSSSSSSSSMSMSAADMSSMSSSSSSSSSMSSSMSMSMMSSSSSSSSMMMMTBBBBBAAABBBBBPPP
PPPTTTTTTTTTTTTTTMMMMSSSSSSMMMSMSMMMMMMMMMSMSMSMMSSMMMMMMMMMSMSMMMSMSMMMSSSSSSMMMMTBBBBBBBAAABBBBPPP
PPPTTTTTTTTTTTTTTTMMMMSSSSSMSSSMSMSSSMSSSSSMSMSSMSSMSSSSSMSMSMSSSMSSSMSMSSSSSMMMMTTBBBBBBBBAAABBBPPP
PPPTTTTTTTTTTTTTTTTMMMMDSSSSSMMMSMMMSMSMMMSMSMMMMSSMMMMMSMSMSMMMSMMMSMSSSSSSKMMMTTTBBBBBBBBBAABBBPPP
PPPTTTTTTTTTTTTTTTTTMMDKSSSSSMSSSMSSSMSSSMSMSSSMMSSMSSSMSMSSSMSSSMSMSSSSSSSKDSMTTTBBBBBBBBBBAAAABPPP
PPPTTTTTTTTTTTTTTTTTMMSSKMSSSSSMMMSMMMMMSMSMMMSMMSSMMMSMSMSMMMSMMMSSSSSSMMMMSTTTBBBBBBBBBBBBBAAAAPPP
PPPTTTTTTTTTTTTTTTTTTTTSMMMSSSSSSSSMSSSSSMSMSMSSMSSMSSSMSMSSSSSMSSSSSSSMMMMMTTTTBTTBBBBBBBBBBBBAAPPP
PPPTTTTTTTTTTTTTTTTTTTTTMMMMMSSSSSSSSMMMMMSMSMXXMSSMSMMMSMMMMSSSSSSMMMMMMMTTTTTTTTTBBBBBBBBBBBBAAPPP
PPPTTTTTTTTTTTTTTTTTTTTTMMMMMMMSSSSSSSSSSMSSSSXXMSSMSSSMSSSSSSSSSSMMMMMMTTTTTBBTTBBBBBBBBBBBBBBBBPPP
PPPTTTTTTTTTTTTTTTTTTTTTTTTMMMMMMMMSSSSSSSSSSSSSSSSSSSSSSSSSSSSMMMMMMMMTTTTTTTTTTBTTBBBBBBBBBBBBBPPP
PPPTTTTTTTTTTTTTTTTTTTTTTTTTTMMMMMMMSSSSSSSSSSSSSSSSSSSSSSSSMMMMMMMMMTTTTTTTTTTTBBTTBBBBBBBBBBBBBPPP
PPPTTTTTTTTTTTTTTTTTTTTTTTTTTTTTMMMMMMMMMMMMSMMMMSSMMMMMMMMMMMMMMMTTTTTTTTTTTTBBTTTTBTTBBBBBBBBBBPPP
PPPTTTTTTTTTTTTTTTTTTTTTTTTTTTTTTTTMMMMMMMMMMMMMMMMMMMMMMMMMMMMTTTTTTTTTTTTTTTTTTTBBBTTBBBBBBBBBBPPP
PPPTTTTTTTTTTTTTTTTTTTTTTTTTTTTTTTTMMMMMMMMMMMMMMMMMMMMMMMMMTTTTTTTTTTTTTTTTTTTTTBTTTTBBTBBBBBBBBPPP
PPPTTTTTTTTTTTTTTTTTTTTTTTTTTTTTTTTTTTTTTTTTTMMMTMMTTTTTTTTTTTTTTTTTTTTTTTTTTTTTTTTTTBBTTTTTTBBBBPPP
PPPPPPPPPPPPPPPPPPPPPPPPPPPPPPPPPPPPPPPPPPPPPPPPPPPPPPPPPPPPPPPPPPPPPPPPPPPPPPPPPPPPPPPPPPPPPPPPPPPP
PPPPPPPPPPPPPPPPPPPPPPPPPPPPPPPPPPPPPPPPPPPPPPPPPPPPPPPPPPPPPPPPPPPPPPPPPPPPPPPPPPPPPPPPPPPPPPPPPPPP
PPPPPPPPPPPPPPPPPPPPPPPPPPPPPPPPPPPPPPPPPPPPPPPPPPPPPPPPPPPPPPPPPPPPPPPPPPPPPPPPPPPPPPPPPPPPPPPPPPPP
