25
25
PPPPPPPPPPPPPPPPPPPPPPPPP
PPPPPPPPPPPPPPPPPPPPPPPPP
PPPPPPPPPPPPPPPPPPPPPPPPP
PPPTTTTMMMMSSSMMSSSSSSPPP
PPPTTTMMSSSSSSMMMSSMSSPPP
PPPTTMMSSMSSMMMMMSSMSSPPP
PPPTMMSSMMSSMSSSMSSMSSPPP
PPPTSSSMMSBBMSMSMSSMMSPPP
PPPTMMMMSBBBMSMSMSSMMSPPP
PPPMMSSSBBBSMSMSMSSMMSPPP
PPPSSSSSBBKSSSMSMMSSMSPPP
PPPSSSSMMMMMMMMSMMSSMSPPP
PPPSSSMSSSMSSSMSSSSSMSPPP
PPPSSSMSMSMSMSMSMMMSMSPPP
PPPSSSSSMSMSMSSSMSSSMSPPP
PPPSMMMMMSMSMMMMMSSSMMPPP
PPPSMSSSMSSSMSSSSSSSSSPPP
PPPSMMMSMMMMMMMMMSSMSSPPP
PPPSSSSSDSSSSSMSSSSTTSPPP
PPPMMAAAAAMMMSMSMMMTXSPPP
PPPMMAAAAASSSSMSSSSSSMPPP
PPPMMMMMMSMMMSMSMMSMMMPPP
PPPPPPPPPPPPPPPPPPPPPPPPP
PPPPPPPPPPPPPPPPPPPPPPPPP
PPPPPPPPPPPPPPPPPPPPPPPPP
