25
25
PPPPPPPPPPPPPPPPPPPPPPPPP
PPPPPPPPPPPPPPPPPPPPPPPPP
PPPPPPPPPPPPPPPPPPPPPPPPP
PPPMSSSSSSMSSSSSSBBBBSPPP
PPPMMSSSSSMMSMMMSSBBBSPPP
PPPMTTSSSSSSSMMSSSSBBSPPP
PPPMTTSSSSSSSSMMMMSSSSPPP
PPPSSSMSSSSSSSMMSSSMSSPPP
PPPMMMSSSSSSSSMMSMSMMSPPP
PPPMSSSMMSSSSSSMMMSSMSPPP
PPPBSMSSSMSSSSSSMMSMMSPPP
PPPBBMSMSMSSSSSSSMSSMSPPP
PPPBBBSSMMMSSSSSSMMSMSPPP
PPPBBBMSSSMMSSSSSSMMMSPPP
PPPSBBMMMSSMMSSSSSSSMSPPP
PPPSSSSSMMSSSMSSSSSSSSPPP
PPPBSSSSMMMMSSMSSSSSSSPPP
PPPBBBSSSSSMMMMSSSSSSSPPP
PPPBBMXXSSSSSSSSSSDDSSPPP
PPPBSMXXMMMMSSSSSSDDSSPPP
PPPMSMSMMMMMMSSSSSSSSSPPP
PPPSSMSSSBBBMMSSSSSSSXPPP
PPPPPPPPPPPPPPPPPPPPPPPPP
PPPPPPPPPPPPPPPPPPPPPPPPP
PPPPPPPPPPPPPPPPPPPPPPPPP
